0000000000
0111111220
0111111220
0101100110
0101111110
0111011110
0111011110
0331111110
0331111110
0000000000
